1111111111111111111111111111111111
1E1000000100011C000000000C00000001
101011C100100000111111111110011101
1000010010001111001001000110010101
111011000001C0000000001000M0000011
1P10110100100000101001100000010101
1010110111101010001001111011010101
100110010010C000000000100000000001
110C111100100010101001000C00010101
1010100010111001001001000000010101
10001C110C1111011110000001000000C1
1011001100001100001001001110110101
1010010010100011101001000100000101
1000000000100000001000C00000000001
1111111111111111111111111111111111
