1111111111111111111111111111111111
1E1000000100011C000000000C00000001
101011C100100000000100111110000101
1000010010001001111011000110010101
111011000001C11000000C1000M0000011
1P10110100100000111001100000011101
1010110111101111000001111011000101
100110010C101000001110100000000001
110C111100100110111001000C00110101
1010100C10110010000001000001110101
10001011001110011110000001000001C1
1011001100001100001001111110110111
101001001010001110100100C100010101
1000000000100000001000000000000001
1111111111111111111111111111111111
