1111111111111111111111111111111111
1E0000000000000C000000000C00000001
101101C100100000101001000110010101
1010010010101010001001000110010101
100011000001C000000000100000000001
1010010100100000101001100000010101
1010010010101010001001111011010101
1P0000000000C000000000100000000001
101C010100100000101001000C00010101
1010010010101110001001000000010101
100000000C100100001000C000000000C1
1111111111111111111111111111111111
