1111111111
100C0000E1
1000000001
1C00000001
1000000001
100000C001
1000000001
1P000000C1
1111111111
