1111111111
100C0000E1
1000111111
1C00000001
1111000001
1000000011
10000111C1
1P00000001
1111111111
